########
#   #  #
#   $$$#
####   #
   #@ ........##
   ####