########
#@  # .#
#     .#
####   #
   #  ##
   ####